[console_scripts]
manila-all = manila.cmd.all:main
manila-api = manila.cmd.api:main
manila-data = manila.cmd.data:main
manila-manage = manila.cmd.manage:main
manila-rootwrap = oslo_rootwrap.cmd:main
manila-scheduler = manila.cmd.scheduler:main
manila-share = manila.cmd.share:main
manila-status = manila.cmd.status:main

[manila.scheduler.filters]
AvailabilityZoneFilter = manila.scheduler.filters.availability_zone:AvailabilityZoneFilter
CapabilitiesFilter = manila.scheduler.filters.capabilities:CapabilitiesFilter
CapacityFilter = manila.scheduler.filters.capacity:CapacityFilter
ConsistentSnapshotFilter = manila.scheduler.filters.share_group_filters.consistent_snapshot:ConsistentSnapshotFilter
CreateFromSnapshotFilter = manila.scheduler.filters.create_from_snapshot:CreateFromSnapshotFilter
DriverFilter = manila.scheduler.filters.driver:DriverFilter
IgnoreAttemptedHostsFilter = manila.scheduler.filters.ignore_attempted_hosts:IgnoreAttemptedHostsFilter
JsonFilter = manila.scheduler.filters.json:JsonFilter
RetryFilter = manila.scheduler.filters.retry:RetryFilter
ShareReplicationFilter = manila.scheduler.filters.share_replication:ShareReplicationFilter

[manila.scheduler.weighers]
CapacityWeigher = manila.scheduler.weighers.capacity:CapacityWeigher
GoodnessWeigher = manila.scheduler.weighers.goodness:GoodnessWeigher
HostAffinityWeigher = manila.scheduler.weighers.host_affinity:HostAffinityWeigher
PoolWeigher = manila.scheduler.weighers.pool:PoolWeigher

[manila.share.drivers.dell_emc.plugins]
isilon = manila.share.drivers.dell_emc.plugins.isilon.isilon:IsilonStorageConnection
powermax = manila.share.drivers.dell_emc.plugins.powermax.connection:PowerMaxStorageConnection
unity = manila.share.drivers.dell_emc.plugins.unity.connection:UnityStorageConnection
vnx = manila.share.drivers.dell_emc.plugins.vnx.connection:VNXStorageConnection

[manila.tests.scheduler.fakes]
FakeWeigher1 = manila.tests.scheduler.fakes:FakeWeigher1
FakeWeigher2 = manila.tests.scheduler.fakes:FakeWeigher2

[oslo.config.opts]
manila = manila.opts:list_opts

[oslo.config.opts.defaults]
manila = manila.common.config:set_middleware_defaults

[oslo.policy.enforcer]
manila = manila.policy:get_enforcer

[oslo.policy.policies]
manila = manila.policies:list_rules

[oslo_messaging.notify.drivers]
manila.openstack.common.notifier.log_notifier = oslo_messaging.notify._impl_log:LogDriver
manila.openstack.common.notifier.no_op_notifier = oslo_messaging.notify._impl_noop:NoOpDriver
manila.openstack.common.notifier.rpc_notifier = oslo_messaging.notify.messaging:MessagingDriver
manila.openstack.common.notifier.rpc_notifier2 = oslo_messaging.notify.messaging:MessagingV2Driver
manila.openstack.common.notifier.test_notifier = oslo_messaging.notify._impl_test:TestDriver

[wsgi_scripts]
manila-wsgi = manila.wsgi.wsgi:initialize_application

